# 00 = player
# 01 = classic tiles
# 02 = wall
# 03 = RightEnemy
# 04 = LeftEnemy
# 05 = UpEnemy
# 06 = DownEnemy
# 07 = power
# 08 = portal
# 15 tiles width (960)
# 10 tiles height (704) (with UI 9)
# level data is map organisation
# config is additional level configuration information

##levelData
02 02 02 02 02 02 02 02 02 02 02 02 02 02 02
02 00 01 01 01 01 01 01 01 01 01 01 01 01 02
02 01 01 01 01 01 02 02 02 01 01 01 01 01 02
02 01 01 01 01 01 02 08 02 01 01 01 01 01 02
02 01 02 02 02 02 02 01 02 02 02 02 02 01 02
02 01 02 01 01 01 01 01 01 01 01 01 04 01 02
02 01 06 01 01 01 01 01 01 01 01 01 02 01 02
02 02 02 02 02 02 02 02 02 02 02 02 02 01 02
02 03 01 01 01 01 01 01 01 01 01 01 01 01 02
02 02 02 02 02 02 02 02 02 02 02 02 02 02 02
##levelData

##numberOfTiles
10
15
##numberOfTiles

##powerAmount
30
##powerAmount

##levelName
EmptyLevel
##levelName